111111111111
011111111110
001111111100
000111111000
000011110000
000001100000