100000000001
110000000011
111000000111
111100001111
111110011111
111100001111
111000000111
110000000011